/map
000010000
000010000
000010000
000220200
112111221
222212000
001112200
010222000
000210000
/endmap
