/map
00000200000000000000000000000000000
00000020000200000020000000000000000
00000002000022000002000000000000000
00000000200002000200200002002000000
02000200020000200020020000200000000
00200020002000002000002000020020000
00020002000200000200000200002000000
00000000200020000000000020000202000
00000000020002000002000000000000000
00000000000000000000000000000000200
00000000000000000000000000000000000
00000000000000000000000000000000000
00000000000000000000000000000000000
00000001111111000000000000000000000
00000001112222000000000000000000000
00000001220000000000000000000000000
00000001200000000000002100000000000
00000001200000000000001100111110000
00000001200000000000000200111110000
00000001120011110100010210221100000
00000001120012110102010110011200000
00000001120022110122210110112220000
00000001111111110111110110111110000
00000001111111110111110110111110000
00000000000000000000000000000000000
00000000000000000000000000000000000
00000000000000000000000000000000000
00000000000000000000000000000000000
00002000002000000200000000000000200
00000200000200200020020020000002000
00000020000020020002002002000002000
00000002002002002000200200200002000
00000000200200200000020020020000000
00000000020020020000002000002000000
00000000002000002000000200000200000
/endmap
